Pay Day
An Interactive Fiction by Tessa Joy Barbosa
Release 1 / Serial number 170213 / Inform 7 build 6M62 (I6/v6.33 lib 6/12N) SD

Floor
Your coworker stands next to the register, waiting for another customer to arrive.

The readied espresso beans sit waiting to be used on the counter.

The clean espresso bean grnder sits next to the espresso machine.

On Counter is Espresso Machine.

The cleaned fridge is right udnerneath the counter.

You can also see espresso shots and latte here.

>grind beans in grinder
You now have shots!

* * *

Pay Day
An Interactive Fiction by Tessa Joy Barbosa
Release 1 / Serial number 170213 / Inform 7 build 6M62 (I6/v6.33 lib 6/12N) SD

Floor
Your coworker stands next to the register, waiting for another customer to arrive.

The readied espresso beans sit waiting to be used on the counter.

The clean espresso bean grnder sits next to the espresso machine.

On Counter is Espresso Machine.

The cleaned fridge is right udnerneath the counter.

You can also see espresso shots and latte here.

>open fridge
You open Fridge, revealing Milk.

* * *

Pay Day
An Interactive Fiction by Tessa Joy Barbosa
Release 1 / Serial number 170213 / Inform 7 build 6M62 (I6/v6.33 lib 6/12N) SD

Floor
Your coworker stands next to the register, waiting for another customer to arrive.

The readied espresso beans sit waiting to be used on the counter.

The clean espresso bean grnder sits next to the espresso machine.

On Counter is Espresso Machine.

The cleaned fridge is right udnerneath the counter.

You can also see espresso shots and latte here.

>patrick
That's not a verb I recognise.

* * *

Pay Day
An Interactive Fiction by Tessa Joy Barbosa
Release 1 / Serial number 170213 / Inform 7 build 6M62 (I6/v6.33 lib 6/12N) SD

Floor
Your coworker stands next to the register, waiting for another customer to arrive.

The readied espresso beans sit waiting to be used on the counter.

The clean espresso bean grnder sits next to the espresso machine.

On Counter is Espresso Machine.

The cleaned fridge is right udnerneath the counter.

You can also see espresso shots and latte here.

>put beans in grinder
(first taking Beans)
You put Beans into Grinder.