It's only your second week working at the iconic starbucks, but you desperatey need your pay check. There is an unbeatable deal on the new iphone 7s, but you need your paycheck to pay for it! Someone changed the four number code to the safe, unfortunately, no one knows the new code to the safe. You need to find the code in order to get your paycheck and the sweet deal on the iphone 7s...

Pay Day
An Interactive Fiction by Tessa Joy Barbosa
Release 1 / Serial number 170225 / Inform 7 build 6M62 (I6/v6.33 lib 6/12N) SD

Floor
You are in a clean, open room with various coffee machines and aparatuses. Your co worker, Patrick, stands by the register in the room.

Your coworker stands next to the register, waiting for another customer to arrive.

The readied espresso beans sit waiting to be used on the counter.

The clean espresso bean grinder sits next to the espresso machine.

The espresso machine is clean and ready for use!

On Counter is register (closed).

The cleaned fridge is right underneath the counter.

You can also see Safe (closed) here.

>combining
That's not a verb I recognise.

* * *

>e
cold room
You can see Ice machine (closed) here.

>n
Back storage
You can see Cabinet (closed) here.

>e
Break room
The famiiar space has a desk, and a coat rack in the corner. There is a lone apron hangind in the corner on the coat rack. There seems to be a pot it with writing on the desk.

There is a small orange post it on the desk. It reads: Heard you needed your paycheck, so I looked into changing the safe code. There should be a man coming in around 1:15 to change the code. His name is Riley. I promised him a pumpkin spice latte on the house, so make sure it is ready for him!

You can also see apron (in which is Key) here.

>take key
Taken.

>w
Back storage
You can see Cabinet (closed) here.

>ulock cabinet
That's not a verb I recognise.

>unlock cabinet
(with Key)
You unlock Cabinet.

>take psl
You can't see any such thing.

>take pumpkin spice
You can't see any such thing.

>open cabinet
You open Cabinet, revealing Pumpkin spice.

>take pumpin spice
You can't see any such thing.

>take pumpkin spice
Taken.

I beg your pardon?

>s
cold room
You can see Ice machine (closed) here.

>w
Floor
Your coworker stands next to the register, waiting for another customer to arrive.

The readied espresso beans sit waiting to be used on the counter.

The clean espresso bean grinder sits next to the espresso machine.

On Counter are register (closed) and Espresso Machine (empty).

The cleaned fridge is right udnerneath the counter.

>take espresso shot
You can't see any such thing.

>undo
Floor
[Previous turn undone.]

>open fridge
You open Fridge, revealing Milk.

>take milk
Taken.

>take beans
Taken.

>grind beans
What do you want to grind Beans in?

>in grinder
I only understood you as far as wanting to grind Beans in inside.

>grinder
That's not a verb I recognise.

>grind bean
You can't see any such thing.

>grind beans
What do you want to grind Beans in?

>grinder
You now have Grounds!

>tke grounds
That's not a verb I recognise.

>use espresso machine
(with Grounds)
You now have Espresso shots!

>take shots
Taken.

>combine shots
What do you want to combine Espresso shots with?

>milk
You now have Latte!

>combine latte
What do you want to combine Latte with?

>pumpkin spice
You now have Pumpkin spice latte!

>w
Lobby
The lobby is filled with chairs, tables, and a condiment bar. Oddly enough there are no customers hanging here out today.

Just a normal table.

You can also see Chairs and Condiment here.

>e
Floor
The clean espresso bean grinder sits next to the espresso machine.

Your coworker stands next to the register, waiting for another customer to arrive.

On Counter is register (closed).

The cleaned fridge is right udnerneath the counter.

You can also see Pumpkin spice, Latte, Milk, Espresso shots, Grounds, Espresso Machine (empty) and Beans here.

>e
cold room
You can see Ice machine (closed) here.

>w
Floor
The clean espresso bean grinder sits next to the espresso machine.

Your coworker stands next to the register, waiting for another customer to arrive.

On Counter is register (closed).

The cleaned fridge is right udnerneath the counter.

You can also see Pumpkin spice, Latte, Milk, Espresso shots, Grounds, Espresso Machine (empty) and Beans here.

>w
Lobby
The lobby is filled with chairs, tables, and a condiment bar. Oddly enough there are no customers hanging here out today.

Just a normal table.

You can also see Chairs and Condiment here.

* * *

>e
Floor
The clean espresso bean grinder sits next to the espresso machine.

Your coworker stands next to the register, waiting for another customer to arrive.

On Counter is register (closed).

The cleaned fridge is right udnerneath the counter.

You can also see Pumpkin spice, Latte, Milk, Espresso shots, Grounds, Espresso Machine (empty) and Beans here.

>w
Lobby
The lobby is filled with chairs, tables, and a condiment bar. Oddly enough there are no customers hanging here out today.

Just a normal table.

You can also see Chairs and Condiment here.

>w
Patio
You can see Wicker chairs and Metal table here.

>e
Lobby
The lobby is filled with chairs, tables, and a condiment bar. Oddly enough there are no customers hanging here out today.

Just a normal table.

You can also see Chairs and Condiment here.

>e
Floor
The clean espresso bean grinder sits next to the espresso machine.

Your coworker stands next to the register, waiting for another customer to arrive.

On Counter is register (closed).

The cleaned fridge is right udnerneath the counter.

You can also see Pumpkin spice, Latte, Milk, Espresso shots, Grounds, Espresso Machine (empty) and Beans here.

* * *

>w
Lobby
The lobby is filled with chairs, tables, and a condiment bar. Oddly enough there are no customers hanging here out today.

Just a normal table.

You can also see Chairs and Condiment here.

>e
Floor
The clean espresso bean grinder sits next to the espresso machine.

Your coworker stands next to the register, waiting for another customer to arrive.

On Counter is register (closed).

The cleaned fridge is right udnerneath the counter.

You can also see Pumpkin spice, Latte, Milk, Espresso shots, Grounds, Espresso Machine (empty) and Beans here.

An important looking man just walked into the lobby, it might be Riley with the code!

* * *

>e
cold room
You can see Ice machine (closed) here.

>w
Floor
Your coworker stands next to the register, waiting for another customer to arrive.

The readied espresso beans sit waiting to be used on the counter.

The clean espresso bean grinder sits next to the espresso machine.

On Counter are register (closed) and Espresso Machine (empty).

The cleaned fridge is right udnerneath the counter.

* * *

>grind beans in grinder
You now have shots!

* * *

>lobby
That's not a verb I recognise.

>eas
That's not a verb I recognise.

>e
cold room
You can see Ice machine (closed) here.

>w
Floor
Your coworker stands next to the register, waiting for another customer to arrive.

The readied espresso beans sit waiting to be used on the counter.

The clean espresso bean grinder sits next to the espresso machine.

On Counter are register (closed) and Espresso Machine (empty).

The cleaned fridge is right udnerneath the counter.

You can also see pumkin spice latte here.

>w
Lobby
The lobby is filled with chairs, tables, and a condiment bar. Oddly enough there are no customers hanging here out today.

Just a normal table.

You can also see Chairs and Condiment here.

>x
What do you want to examine?

>chairs
old but sturdy.

>x tables
You see nothing special about Tables.

>e
Floor
Your coworker stands next to the register, waiting for another customer to arrive.

The readied espresso beans sit waiting to be used on the counter.

The clean espresso bean grinder sits next to the espresso machine.

On Counter are register (closed) and Espresso Machine (empty).

The cleaned fridge is right udnerneath the counter.

You can also see pumkin spice latte here.

>e
cold room
You can see Ice machine (closed) here.

>open
(Ice machine)
You open Ice machine, revealing ice.

>take ice
Taken.

>ice
That's not a verb I recognise.

>x ice
You see nothing special about ice.

>x me
As good-looking as ever.

>w
Floor
Your coworker stands next to the register, waiting for another customer to arrive.

The readied espresso beans sit waiting to be used on the counter.

The clean espresso bean grinder sits next to the espresso machine.

On Counter are register (closed) and Espresso Machine (empty).

The cleaned fridge is right udnerneath the counter.

You can also see pumkin spice latte here.

* * *

>w
Lobby
The lobby is filled with chairs, tables, and a condiment bar. Oddly enough there are no customers hanging here out today.

Just a normal table.

You can also see Chairs and Condiment here.

>e
Floor
Your coworker stands next to the register, waiting for another customer to arrive.

The readied espresso beans sit waiting to be used on the counter.

The clean espresso bean grinder sits next to the espresso machine.

On Counter are register (closed) and Espresso Machine (empty).

The cleaned fridge is right udnerneath the counter.

You can also see pumkin spice latte here.

>w
Lobby
The lobby is filled with chairs, tables, and a condiment bar. Oddly enough there are no customers hanging here out today.

Just a normal table.

You can also see Chairs and Condiment here.

* * *

>e
Floor
Your coworker stands next to the register, waiting for another customer to arrive.

The readied espresso beans sit waiting to be used on the counter.

The clean espresso bean grinder sits next to the espresso machine.

On Counter are register (closed) and Espresso Machine (empty).

The cleaned fridge is right udnerneath the counter.

You can also see pumkin spice latte here.

>tke undo
That's not a verb I recognise.

>undo
Floor
[Previous turn undone.]

>undo
Lobby
[Previous turn undone.]

>take pumpkin spice latte
You can't see any such thing.

* * *

>open fridge
You open Fridge, revealing Milk.

* * *

>take beans
Taken.

>grind bena
You can't see any such thing.

>grind beans
What do you want to grind Beans in?

* * *

>grinder
You now have Grounds!

>use espresso machine
(with Grounds)
You now have Espresso shots!

>combine shots and latte
You can't use multiple objects with that verb.

>combine shots
(with Milk)
You now have Latte!

>e
cold room
This small room only hold an ice machine in the corner.

>e
You can't go that way.

>n
Back storage
Someone hasn't been ordering new ingredients! The shelves are completely empty, and there is only a small cabinet in the corner that could possibly hold something useful.

>e
Break room
The famiiar space has a desk, and a coat rack in the corner. There is a lone apron hangind in the corner on the coat rack. There seems to be a pot it with writing on the desk.

There is a small orange post it on the desk. It reads: Heard you needed your paycheck, so I looked into changing the safe code. There should be a man coming in around 1:15 to change the code. His name is Cole. I promised him a pumpkin spice latte on the house, so make sure it is ready for him!

>take key
Taken.

>w
Back storage
Someone hasn't been ordering new ingredients! The shelves are completely empty, and there is only a small cabinet in the corner that could possibly hold something useful.

>unlock cabinet
(with Key)
You unlock Cabinet.

>open cabinet
You open Cabinet, revealing Pumpkin spice.

>take pumpkin spice
Taken.

>combine pumpkin spice with latte
You can't see any such thing.

>combine latte
You can't see any such thing.

>combine pumpkin spice
What do you want to combine Pumpkin spice with?

>latte
You can't see any such thing.

>i
You are carrying:
  Pumpkin spice
  Key

* * *

>take beans
Taken.

>put beans in grinder
You put Beans into Grinder.

>grind beans
(in Milk)
You can't combine Beans and Milk into anything useful.

>grind beans in grinder
You now have grounds!

>take grounds
Taken.

>put grounds in espresso machine
You put grounds into Espresso Machine.

>use espresso machine
(with grounds)
You now have espresso shots!

>use espresso machine and grounds
You can't use multiple objects with that verb.

>use grounds
(with grounds)
You can't combine grounds and grounds into anything useful.

>use grounds and espresso machine
You can't use multiple objects with that verb.

>use grounds and espresso machine
You can't use multiple objects with that verb.

* * *

>open fridge
You open Fridge, revealing Milk.

>take milke
You can't see any such thing.

>take milk
Taken.

* * *

>use espresso machine
(with Grounds)
You now have Espresso shots!

>combine shots
What do you want to combine Espresso shots with?

* * *

>milk
You now have Latte!

>e
cold room
This small room only hold an ice machine in the corner.

>n
Back storage
Someone hasn't been ordering new ingredients! The shelves are completely empty, and there is only a small cabinet in the corner that could possibly hold something useful.

* * *

>w
Back storage
Someone hasn't been ordering new ingredients! The shelves are completely empty, and there is only a small cabinet in the corner that could possibly hold something useful.

>unlock cabinet
What do you want to unlock Cabinet with?

>key
You unlock Cabinet.

>open cabinet
You open Cabinet, revealing Pumpkin spice.

* * *

>take pumpkin spice
Taken.

>combine pumpkin spice
What do you want to combine Pumpkin spice with?

>latte
You now have Pumpkin spice latte!
An important looking man just walked into the lobby, it might be Cole with the code!

>go to lobby
You can't see any such thing.

>s
cold room
This small room only hold an ice machine in the corner.

>w
Floor
You are in a clean, open room with various coffee machines and aparatuses. Your co worker stands by the register in the room.

The espresso machine is clean and ready for use!

The clean espresso bean grinder sits next to the espresso machine.

Your coworker stands next to the register, waiting for another customer to arrive.

On Counter is register (closed).

The cleaned fridge is right underneath the counter.

You can also see Latte, Pumpkin spice, Milk, Espresso shots, Grounds and Beans here.

>w
Lobby
The lobby is filled with chairs, tables, and a condiment bar. Oddly enough there are no customers hanging here out today.

Just a normal table.

You can also see Chairs here.

>talk to cole
The man turns toward you. "Hi, I'm Cole. I was called to bring in the new code for the safe. I was told to meet someone here I was in the area, so I decied to just come early.. I also was told there would be a pumpkin spice latte?

>give cole pumpkin spice latte
You hand Cole the pumpkin spice latte and he says "Thanks, I love these things so much! The code is: 2145. See ya later."

>e
Floor
You are in a clean, open room with various coffee machines and aparatuses. Your co worker stands by the register in the room.

The espresso machine is clean and ready for use!

The clean espresso bean grinder sits next to the espresso machine.

Your coworker stands next to the register, waiting for another customer to arrive.

On Counter is register (closed).

The cleaned fridge is right underneath the counter.

You can also see Latte, Pumpkin spice, Milk, Espresso shots, Grounds and Beans here.

>2145
the safe unlocked with a click.

>open safe
You open Safe, revealing Pay check.

>take pay check
Your pay check sits there on the top of the stack. It looks like you got $500, more than enough for a new iphone 7s!

    *** The End ***

Would you like to RESTART, RESTORE a saved game, QUIT or UNDO the last command?

* * *

>open register
You open register, revealing nothing.

>x fridge
There are milk stains running down the front.

>x register
Just an ordinary register. The corner of a piece of paper is sticking out of the register. There seems to be writing on the paper.

>x piece of paper
You can't see any such thing.

>take paper
Taken.

>x paper
The piece of paper reads: " Recipe for Pumpkin spice latte (psl). " 1. Grind beans in grinder to create grounds 2. use espresso machine with grounds to create espresso shots 3. combine milk with espresso shots to create latte 4. combine latte with pumpkin spice to get pumpkin spice latte (psl).

>open fridge
You open Fridge, revealing Milk.

* * *

>take milk
Taken.

>x counter
a clean marble surface.

On Counter are Beans, register, Grinder (empty) and Espresso Machine (empty).

>x beans
A silver five-pound bag of espresso beans.

>take beans
Taken.

>x grinder
just an ordinary grinder.

>put beans in grinder
You put Beans into Grinder.

>grind beans
What do you want to grind Beans in?

* * *

>grinder
You now have Grounds!

>take grounds
You already have that.

>x paper
The piece of paper reads: " Recipe for Pumpkin spice latte (psl). " 1. Grind beans in grinder to create grounds 2. use espresso machine with grounds to create espresso shots 3. combine milk with espresso shots to create latte 4. combine latte with pumpkin spice to get pumpkin spice latte (psl).

>x espresso machine
shiny, new and ready for use.

>put grounds in espresso machine
You put Grounds into Espresso Machine.

>put milk in espresso machine
You put Milk into Espresso Machine.

>mix
That's not a verb I recognise.

>i
You are carrying:
  Paper

>use espresso machine
(with Grounds)
You now have Espresso shots!

>combine with milk
You can't see any such thing.

>take milk
Taken.

>combine milk with espresso shots
You now have Latte!

>talk to coworker
You can't see any such thing.

>talk Patrick
I didn't understand that sentence.

>talk to Patrick
Patrick turns toward you and says cheerfully "Hey good to see you again! I think that the boss man left a note for you in the break room, something about a guy coming in to drop off the new safe code? Oh and I almost forgot, we are having a shortage of supplies so boss man wanted me to remind you that we can't eat anything!"

>s
You can't go that way.

>w
Lobby
The lobby is filled with chairs, tables, and a condiment bar. Oddly enough there are no customers hanging here out today.

You can see Chairs and Tables here.

>e
Floor
You are in a clean, open room with various coffee machines and aparatuses. Your co worker stands by the register in the room.

The espresso machine is clean and ready for use!

The clean espresso bean grinder sits next to the espresso machine.

Your coworker stands next to the register, waiting for another customer to arrive.

On Counter is register.

The cleaned fridge is right underneath the counter.

You can also see Espresso shots, Milk, Grounds and Beans here.

>w
Lobby
The lobby is filled with chairs, tables, and a condiment bar. Oddly enough there are no customers hanging here out today.

You can see Chairs and Tables here.

>w
Patio
A nice veranda running along the side of the building. There are some wicker chairs and metal tables under the awning.

>north
Dump
There is a dumpster here.

>x dumpster
a green metal bin filled with lot  of trash.

>s
Patio
A nice veranda running along the side of the building. There are some wicker chairs and metal tables under the awning.

>n
Dump
There is a dumpster here.

>take trash
Taken.

>s
Patio
A nice veranda running along the side of the building. There are some wicker chairs and metal tables under the awning.

>s
You can't go that way.

>e
Lobby
The lobby is filled with chairs, tables, and a condiment bar. Oddly enough there are no customers hanging here out today.

You can see Chairs and Tables here.

>e
Floor
You are in a clean, open room with various coffee machines and aparatuses. Your co worker stands by the register in the room.

The espresso machine is clean and ready for use!

The clean espresso bean grinder sits next to the espresso machine.

Your coworker stands next to the register, waiting for another customer to arrive.

On Counter is register.

The cleaned fridge is right underneath the counter.

You can also see Espresso shots, Milk, Grounds and Beans here.

>e
cold room
This small room only hold an ice machine in the corner.

>x ice machine
A big silver metal machine.

>take icea
You can't see any such thing.

>take ice
You can't see any such thing.

>open ice machine
You open Ice machine, revealing nothing.

>take ice
Taken.

>n
Back storage
Someone hasn't been ordering new ingredients! The shelves are completely empty, and there is only a small cabinet in the corner that could possibly hold something useful.

>x small cabinet
You can't see any such thing.

>x cabinet
There seems to be something important in the cabinet, but its locked.

>i
You are carrying:
  Ice
  Trash
  Latte
  Paper

>e
Break room
The familiar space has a desk, and a coat rack in the corner. There is a lone apron hanging in the corner on the coat rack. There seems to be a pot it with writing on the desk.

There is a small orange post it on the desk. It reads: Heard you needed your paycheck, so I looked into changing the safe code. There should be a man coming in around 1:15 to change the code. His name is Cole. I promised him a pumpkin spice latte on the house, so make sure it is ready for him!

>x pot
You can't see any such thing.

>x postit
You can't see any such thing.

>x post it
You can't see any such thing.

>x orange post it
You can't see any such thing.

>x note
You can't see any such thing.

>wait
Time passes.

>wait
Time passes.

>wait ten minutes
I only understood you as far as wanting to wait.

>x desk
You can't see any such thing.

>x coat rack
You can't see any such thing.

>take coat
You can't see any such thing.

>take apron
Taken.

>i
You are carrying:
  Apron (open)
    Key
  Ice
  Trash
  Latte
  Paper

>put on apron
You can't wear that!

>take key
Taken.

>s
Dish room
There is a sink with a lot of diches in it. They look dirty.

>n
Break room
The familiar space has a desk, and a coat rack in the corner. There is a lone apron hanging in the corner on the coat rack. There seems to be a pot it with writing on the desk.

There is a small orange post it on the desk. It reads: Heard you needed your paycheck, so I looked into changing the safe code. There should be a man coming in around 1:15 to change the code. His name is Cole. I promised him a pumpkin spice latte on the house, so make sure it is ready for him!

>w
Back storage
Someone hasn't been ordering new ingredients! The shelves are completely empty, and there is only a small cabinet in the corner that could possibly hold something useful.

>s
cold room
This small room only hold an ice machine in the corner.

>n
Back storage
Someone hasn't been ordering new ingredients! The shelves are completely empty, and there is only a small cabinet in the corner that could possibly hold something useful.

>unlock cabinet with key
You unlock Cabinet.

>x cabinet
There seems to be something important in the cabinet, but its locked.

>open cabinet
You open Cabinet, revealing Pumpkin spice.

* * *

>take pumpkin spice
Taken.

>e
Break room
The familiar space has a desk, and a coat rack in the corner. There is a lone apron hanging in the corner on the coat rack. There seems to be a pot it with writing on the desk.

There is a small orange post it on the desk. It reads: Heard you needed your paycheck, so I looked into changing the safe code. There should be a man coming in around 1:15 to change the code. His name is Cole. I promised him a pumpkin spice latte on the house, so make sure it is ready for him!

>w
Back storage
Someone hasn't been ordering new ingredients! The shelves are completely empty, and there is only a small cabinet in the corner that could possibly hold something useful.

* * *

>s
cold room
This small room only hold an ice machine in the corner.

>w
Floor
You are in a clean, open room with various coffee machines and aparatuses. Your co worker stands by the register in the room.

The espresso machine is clean and ready for use!

The clean espresso bean grinder sits next to the espresso machine.

Your coworker stands next to the register, waiting for another customer to arrive.

On Counter is register.

The cleaned fridge is right underneath the counter.

You can also see Espresso shots, Milk, Grounds and Beans here.

>combine latte with pumpkin spice
You now have Pumpkin spice latte!
An important looking man just walked into the lobby, it might be Cole with the code!

>give cole pumpkin spice latte
You can't see any such thing.

>i
You are carrying:
  Pumpkin spice latte
  Key
  Apron (open but empty)
  Ice
  Trash
  Paper

>e
cold room
This small room only hold an ice machine in the corner.

>w
Floor
You are in a clean, open room with various coffee machines and aparatuses. Your co worker stands by the register in the room.

The espresso machine is clean and ready for use!

The clean espresso bean grinder sits next to the espresso machine.

Your coworker stands next to the register, waiting for another customer to arrive.

On Counter is register.

The cleaned fridge is right underneath the counter.

You can also see Pumpkin spice, Latte, Espresso shots, Milk, Grounds and Beans here.

>w
Lobby
The lobby is filled with chairs, tables, and a condiment bar. Oddly enough there are no customers hanging here out today.

You can see Chairs and Tables here.

>talk to Cole
The man turns toward you. "Hi, I'm Cole. I was called to bring in the new code for the safe. I was told to meet someone here I was in the area, so I decided to come by. I also was told there would be a pumpkin spice latte?

>give pumpkin spice latte
(to Cole)
You hand Cole the pumpkin spice latte and he says "Thanks, I love these things so much! The code is: 2145. See ya later."

>s
Bathroom
A clean well lit room with a toilet and a sink.

>n
Lobby
The lobby is filled with chairs, tables, and a condiment bar. Oddly enough there are no customers hanging here out today.

You can see Chairs and Tables here.

>e
Floor
You are in a clean, open room with various coffee machines and aparatuses. Your co worker stands by the register in the room.

The espresso machine is clean and ready for use!

The clean espresso bean grinder sits next to the espresso machine.

Your coworker stands next to the register, waiting for another customer to arrive.

On Counter is register.

The cleaned fridge is right underneath the counter.

You can also see Pumpkin spice, Latte, Espresso shots, Milk, Grounds and Beans here.

>x counter
a clean marble surface.

On Counter is register.

>x safe
A black code safe. It looks like you need a code to unlock it. The instructions read: enter code, then open door.

>x under counter
You can't see any such thing.

>enter code
You can't see any such thing.

>x safe
A black code safe. It looks like you need a code to unlock it. The instructions read: enter code, then open door.

>unlock safe
What do you want to unlock Safe with?

>2145
the safe unlocked with a click.

* * *

>patrick
That's not a verb I recognise.

>talk to patrick
That's not a verb I recognise.

* * *

>put beans in grinder
(first taking Beans)
You put Beans into Grinder.

>grind beans
What do you want to grind Beans in?

>grinder
You now have espresso shots!

>open fridge
You open Fridge, revealing Milk.

* * *

>take milk
Taken.

>combine milk
(with Milk)
You can't combine Milk and Milk into anything useful.

>combine shots
(with Milk)
You now have latte!

* * *

>put beans in grinder
(first taking Beans)
You put Beans into Grinder.

>shots
That's not a verb I recognise.

>combine shots and milk
You can't use multiple objects with that verb.

>combine milk
You can't see any such thing.

* * *

>take
What do you want to take?

>x patrick
You see nothing special about Patrick.

>talk to patrick
Patrick turns toward you and says cheerfully "Hey good to see you again! I think that the boss man left a note for you in the break room, something about a guy coming in to drop off the new safe code?

* * *

>take all
pumkin spice latte: Taken.
Beans: Taken.
register: Taken.
Espresso Machine: Taken.

* * *

>take beans
Taken.

>open fridge
You open Fridge, revealing Milk.

* * *

>take milk
Taken.

>grind beans
What do you want to grind Beans in?

* * *

>grinder
You now have Grounds!

>talk to patrick
Patrick turns toward you and says cheerfully "Hey good to see you again! I think that the boss man left a note for you in the break room, something about a guy coming in to drop off the new safe code?

* * *

>take milk
You can't see any such thing.

>open fridge
You open Fridge, revealing Milk.

* * *

>take grounds
You already have that.

>use espresso machine
(with Grounds)
You now have Espresso shots!

>take espresso shots
Taken.

>combine espresso shots with milk
You now have Latte!

>w
Lobby
The lobby is filled with chairs, tables, and a condiment bar. Oddly enough there are no customers hanging here out today.

Just a normal table.

You can also see Chairs and Condiment here.

>e
Floor
The clean espresso bean grinder sits next to the espresso machine.

Your coworker stands next to the register, waiting for another customer to arrive.

On Counter is register (closed).

The cleaned fridge is right udnerneath the counter.

You can also see Milk, Espresso shots, Grounds, Espresso Machine (empty) and Beans here.

>e
cold room
You can see Ice machine (closed) here.

* * *

>n
Back storage
You can see Cabinet (closed) here.

>w
You can't go that way.

>e
Break room
The famiiar space has a desk, and a coat rack in the corner. There is a lone apron hangind in the corner on the coat rack. There seems to be a pot it with writing on the desk.

There is a small orange post it on the desk. It reads: Heard you needed your paycheck, so I looked into changing the safe code. There should be a man coming in around 1:15 to change the code. His name is Riley. I promised him a pumpkin spice latte on the house, so make sure it is ready for him!

You can also see apron here.

>take key
Taken.

* * *

>w
Back storage
You can see Cabinet (closed) here.

>unlock cabinet
What do you want to unlock Cabinet with?

* * *

>key
You unlock Cabinet.

>open
What do you want to open?

>cabinet
You open Cabinet, revealing Pumpkin spice.

>take pumpkin spice
Taken.

* * *

>combine pumpkin spice
What do you want to combine Pumpkin spice with?

>latte
You now have Pumpkin spice latte!
An important looking man just walked into the lobby, it might be Riley with the code!

* * *

>w
Lobby
The lobby is filled with chairs, tables, and a condiment bar. Oddly enough there are no customers hanging here out today.

Just a normal table.

You can also see Chairs here.

>e
Floor
You are in a clean, open room with various coffee machines and aparatuses. Your co worker stands by the register in the room.

Your coworker stands next to the register, waiting for another customer to arrive.

The readied espresso beans sit waiting to be used on the counter.

The clean espresso bean grinder sits next to the espresso machine.

The espresso machine is clean and ready for use!

On Counter is register (closed).

The cleaned fridge is right underneath the counter.

>e
cold room
This small room only hold an ice machine in the corner.

>n
Back storage
You can see Cabinet (closed) here.

>e
Break room
The famiiar space has a desk, and a coat rack in the corner. There is a lone apron hangind in the corner on the coat rack. There seems to be a pot it with writing on the desk.

There is a small orange post it on the desk. It reads: Heard you needed your paycheck, so I looked into changing the safe code. There should be a man coming in around 1:15 to change the code. His name is Riley. I promised him a pumpkin spice latte on the house, so make sure it is ready for him!

You can also see apron here.

>look inside apron
Apron is empty.

>take key
Taken.

>s
Dish room

>n
Break room
The famiiar space has a desk, and a coat rack in the corner. There is a lone apron hangind in the corner on the coat rack. There seems to be a pot it with writing on the desk.

There is a small orange post it on the desk. It reads: Heard you needed your paycheck, so I looked into changing the safe code. There should be a man coming in around 1:15 to change the code. His name is Riley. I promised him a pumpkin spice latte on the house, so make sure it is ready for him!

You can also see apron (empty) here.

>w
Back storage
You can see Cabinet (closed) here.

>unlock cabinet
(with Key)
You unlock Cabinet.

>open
(Key)
It isn't something you can open.

>open cabinet
You open Cabinet, revealing Pumpkin spice.

* * *

>take pumpkin spice
Taken.

>s
cold room
You can see Ice machine (closed) here.

* * *

>w
Floor
Your coworker stands next to the register, waiting for another customer to arrive.

The readied espresso beans sit waiting to be used on the counter.

The clean espresso bean grinder sits next to the espresso machine.

On Counter are register (closed) and Espresso Machine (empty).

The cleaned fridge is right udnerneath the counter.

>open fridge
You open Fridge, revealing Milk.

* * *

>take grounds
You already have that.

>use grounds
(with Grounds)
You can't combine Grounds and Grounds into anything useful.

>use expresso machine
You can't see any such thing.

>use esspresso machine
You can't see any such thing.

>use espresso machine
(with Grounds)
You now have Espresso shots!

>take espresso
(Espresso Machine)
Taken.

>combine milk and espresso shots
You can't use multiple objects with that verb.

>combine milk
What do you want to combine Milk with?

>espresso shots
You now have Latte!

>combine latte
What do you want to combine Latte with?

* * *

>pumpkin spice
You now have Pumpkin spice latte!

>take pumpkin spice latte
You already have that.

* * *

>e
cold room
This small room only hold an ice machine in the corner.

>s
You can't go that way.

>n
Back storage
Someone hasn't been ordering new ingredients! The shelves are completely empty, and there is only a small cabinet in the corner that could possibly hold something useful.

* * *

>e
Break room
The famiiar space has a desk, and a coat rack in the corner. There is a lone apron hangind in the corner on the coat rack. There seems to be a pot it with writing on the desk.

There is a small orange post it on the desk. It reads: Heard you needed your paycheck, so I looked into changing the safe code. There should be a man coming in around 1:15 to change the code. His name is Cole. I promised him a pumpkin spice latte on the house, so make sure it is ready for him!

>x apron
A grean apron. There seems to be a key in the pocket. It might come in handy later.

* * *

>e
cold room
This small room only hold an ice machine in the corner.

>x ice machine
You see nothing special about Ice machine.

* * *

>x register
You see nothing special about register.